1111111111111111111111111111111111
10C00000e0000C0000000e000000000001
1010010100101000100001000000010001
1010010010101010001001000100010101
1000000111000010001000010100000001
10000001010000E00010e0010100000001
1000000111000000001000010111111111
1P00000000000e00001000010000000C01
1111111111111111111111111111111111
