11111111111111111111
1000000000000e000001
1001e0011C1110100E01
10111001010100100001
11e00101101110111001
1000P0000000C0000001
1C0000000e0000000001
11111111111111111111